Zombie: Cloth Tunic, Baselard
Axe Armor: Black Belt
Killer Fish: Potato Pancake
Bone Pillar: Mind Up
Zombie Soldier: Rotten Meat, Combat Knife
Skeleton Knight: Katana
Tiny Devil: Beef Curry
Durga: Gym Clothes, Coffee
Rock Armor: Bastard Sword, Gym Clothes
Winged Skeleton: Hammer
Minotaur: Lance, Coffee
Student Witch: Mind Up, Cream Soda
Arachne: Tea
Fleaman: Cloth Tunic
Evil Butcher: Short Sword, Ancient Book 3
Quetzalcoatl: Iron Plate
Ectoplasm: Persimmom
Catobleapas: Milk
Ghost Dancer: Anti Venom
Waiter Skeleton: CASTLE MAP 2
Zombie Officer: Combat Knife, Flame Necklace
Wooden Golem: Cream Puff
Persephone: Scarf, Melon
Lilith: Pendant
Chronomage: Pudding
Valkryie: Kunitsuna, Heart Pendant
Witch: Mana Prism, Handgun
Curly: Skull Necklace, Casual Clothes
Cockatrice: Coffee
Dead Warrior: Ancient Belt
Devil: Skull Necklace, Strawberry
Imp: Tea
Werewolf: Iron Plate, Milk
Gorgon: Meat Strip, Mind Up
Disc Armor: Silk Robe
Golem: High Potion
Manticore: Osafune
Bomber Armor: Elfin Robe
Great Armor: Iron Plate, Claymore
Giant Worm: Cream Puff
Needles: Tea
Man Eater: Durandal
Nightmare: Claymore
Triton: Hammer, Potato Pancake
Big Golem: Burtgang
Dryad: Durandal, Anti Venom
Poison Worm: Cream Soda
Arc Demon: Tea
Cagnazzo: Anti Venom, Poison Fist
Ripper: Crimson Cloak
Werejaguar: Bastard Sword
Alura Une: Meat Strip
Flesh Golem: Rotten Meat, Spoiled Milk
Dead Crusader: Mach Punch, Rare Ring
Kicker Skeleton: Casual Clothes, Flame Necklace
Weretiger: Ascalon
Killer Mantle: High Mind Up
Red Minotaur: Cutall, Grapes
Skull Millione: Poison Fist, Mystletain
Giant Skeleton: Rahab's Sword
Succubus: Soldier Uniform, Grapes
Stolas: Milk
Erinys: Laevatain
Lubicant: Silver Gun
Basilisk: Great Sword
Demon Lord: Mana Prism, Eversing
Final Guard: Dracula's Tunic, Silver Gun
Flame Demon: Ronginus' Spear
Shadow Knight: Super Potion
